111111111111111
100000000000003
100000000000011
100000000000041
111111111111111