1111311111111111111111
1400000000000000000001
1111111111111111111101
1000000000000000000001
1111011100111101110111
1111011110011101110111
1100000111001101110111
1111011111100101100011
1111011111110001111111
1111011111111001111111
1111011111111100111111
1111011111100000001111
1111001111111111001111
1111100111111111000111
1111110011111110010001
3000000001111100111111
1111111100000001111111
1111111110011111111111
1111111111111111111111
1111111111111111111111
1111111111111111111111
1111111111111111111111
1111111111111111111111
