1111111111111111111111111111
1000000010000000001000000001
1011111010111011101011111101
1000001010100000101010000001
1111101010101310101010101011
1000001010101410101010101011
1011111010100000101010100011
1000011010111111101010010111
1111001010000000001011010001
1000101011111011111010011101
1010001000000000000010000001
1011111111111111111111111111
1000000000000000000000000001
1011011111111111011101111101
1011000000010000000101100001
1000011111110111011101111101
1011000000000000001100000001
1001111111000111100000111111
1100000000110000111110000001
1011111110000000001111111101
1000000000111011100000000011
1111111111000001111111111001
3000000000011100000000000011
1111111111111111111111111111