1111111111111                                       
11100100000001                                     
111110000000001                                      
3400000000000003                                      
1111100000000001                                      
111  10000000001                                      
11    100000001   1111111                                      
1      1000001   10000001                                      
        10001    10011101                                      
         101      1001111                                      
        10001      1001                                      
       1000001      1001                                           
      100000001     10011111111111111111                                      
     10000000001     10000000000000000001                                      
     100000000011111  11111100000000000001                                     
     1000000000000001111111000000000000000111111111                                      
     1000000000000000000000000000000000000000000001                                      
     1000000000000000000000000000000000000000000001                                      
      100000000000001111110000000000000000111111001                                      
       1111111111111      1000000000000001     1001                                      
                           10000000000001      1001                                      
                            111111111111       1001                                     
                                               1111                                      
